able :: fumela 
about :: kapim 
accident :: fituje 
account :: menoka 
acid :: watenu 
across :: josoko 
act :: jilufe 
addition :: wosebi 
after :: bafema 
again :: wikef 
against :: fifufo 
agreement :: similu 
air :: wifawe 
all :: bomem 
almost :: fipolu 
among :: nelobi 
amount :: pemona 
and :: sowu 
angle :: supofa 
angry :: likoja 
animal :: popike 
answer :: fokofo 
any :: sojan 
anything :: kela 
apple :: pikulo 
approval :: wiweno 
argument :: sisana 
arm :: lanuwe 
army :: kalutu 
art :: kowonu 
as :: muwak 
at :: kufim 
attack :: kisate 
attempt :: sekuja 
attention :: jobeku 
authority :: pubowu 
awake :: pakume 
away :: bufak 
baby :: besesu 
back :: nole 
bad :: topik 
bag :: jotaka 
balance :: sumafu 
ball :: jinolu 
band :: lomuto 
base :: nasupi 
basket :: temini 
bath :: nolosu 
be :: mufe 
beautiful :: bujufi 
because :: kijo 
bed :: fisama 
bee :: tusani 
before :: wetow 
behavior :: pofuko 
belief :: woseti 
bell :: mojefi 
bent :: wusiwu 
between :: folifo 
big :: kasok 
bird :: mipuki 
birth :: nuwofo 
bit :: fatimu 
bite :: minino 
bitter :: tomeku 
black :: japipa 
blade :: tibawu 
blood :: fitani 
blow :: jomemi 
blue :: kutuju 
board :: lefabi 
boat :: jonofi 
body :: finos 
bone :: pebafe 
book :: fojato 
boot :: toloji 
bottle :: lupuma 
bottom :: lawuti 
box :: lujusi 
boy :: belutu 
brain :: kinili 
branch :: wanowi 
brass :: tobaka 
bread :: nususa 
breath :: mekobi 
brick :: wajipi 
bridge :: masete 
bright :: mesewi 
broken :: konowi 
brother :: bufofe 
brown :: lesaka 
brush :: tajumu 
bucket :: wapisi 
bug :: lamine 
building :: jisape 
burn :: lisune 
burst :: witofi 
business :: bolemo 
but :: fojib 
butter :: punolo 
button :: kawuba 
by :: pofan 
cake :: mebiju 
camera :: limuna 
can :: leto 
card :: kapuwe 
care :: besowu 
carriage :: wulelu 
cart :: wenosi 
cat :: lakowo 
cause :: bomefu 
certain :: kebase 
chain :: pufoni 
chance :: faliwu 
change :: fanajo 
cheap :: nafoju 
cheese :: mokafu 
chemical :: tojiki 
chest :: mimujo 
chief :: kinelu 
chin :: tikulu 
church :: kumake 
circle :: poteto 
clean :: jekute 
clear :: fomuja 
clock :: likopu 
cloud :: tofine 
coat :: mikafa 
cold :: bosipu 
collar :: tupebe 
color :: wekepo 
come :: fiki 
comfort :: sinefa 
committee :: pomofe 
common :: menomo 
company :: jakapu 
competition :: pulawu 
complete :: lukana 
complex :: tewola 
condition :: motaju 
connection :: pabipe 
control :: jasinu 
cook :: mawobu 
copy :: lufimu 
cotton :: tafuwo 
cough :: wikito 
country :: fulinu 
cover :: josipi 
cow :: pekumi 
crack :: nimawu 
crazy :: patap 
credit :: masabi 
crime :: kosino 
cruel :: sepawi 
crush :: sisumo 
cry :: lanila 
cup :: lukile 
current :: sipoja 
curtain :: tutuko 
cut :: fawofo 
damage :: nijofa 
danger :: metoto 
dark :: junobi 
daughter :: fonebe 
day :: wepip 
dead :: biboko 
dear :: febiti 
death :: bukuf 
debt :: tafite 
decision :: litifa 
deep :: kinipi 
degree :: susita 
delicate :: wefipu 
design :: sopoma 
desire :: puwase 
destruction :: tofomu 
detail :: sawuli 
development :: tinalo 
device :: wemete 
difference :: juwike 
different :: fesisi 
direction :: pesiko 
dirty :: bujeti 
discovery :: tofumu 
discussion :: titame 
disease :: pawume 
distance :: pejabu 
division :: senoto 
do :: bimuj 
dog :: fipuko 
door :: bowata 
doubt :: lelaka 
down :: petej 
drain :: wineno 
drawer :: tibawi 
dress :: junuku 
drink :: fabutu 
driving :: kiwulo 
drop :: jasupa 
dry :: mewuse 
dust :: petiju 
ear :: nipepo 
early :: jimope 
earth :: jiseku 
east :: luwali 
edge :: pileki 
education :: samala 
effect :: petamu 
egg :: pefawa 
electric :: sinuju 
end :: pekot 
engine :: nipumo 
enough :: besili 
equal :: tekafo 
error :: wekapa 
even :: tawut 
event :: pasote 
ever :: wufiw 
every :: bekusa 
everything :: jusaw 
example :: nuboka 
exchange :: safile 
existence :: tofiwu 
experience :: lepepu 
expert :: pomino 
eye :: lifelu 
face :: bubime 
fact :: fomose 
fall :: jetepe 
false :: pujowi 
family :: biwome 
far :: fejupu 
farm :: notupu 
fat :: kifefi 
father :: batuwa 
fear :: lajaso 
feel :: wetok 
feeling :: fopena 
female :: nojafo 
field :: kulami 
fight :: wikab 
finger :: mupine 
fire :: nejoj 
first :: titib 
fish :: busenu 
fixed :: ninebi 
flag :: sikufe 
flame :: welona 
flat :: pawoba 
flight :: lewute 
floor :: jipipi 
flower :: piwaja 
fly :: kefoji 
fold :: winusu 
food :: pabulu 
foolish :: sijulu 
foot :: sotuja 
for :: bijej 
force :: kufake 
fork :: weseto 
form :: mififa 
forward :: koloke 
frame :: talamu 
free :: fojane 
friend :: biketa 
from :: nikuf 
front :: womamu 
fruit :: wikute 
full :: fosefi 
fun :: babot 
furniture :: kelupu 
future :: jipime 
game :: simoti 
garden :: panope 
general :: jifaka 
get :: butij 
girl :: batuno 
give :: bufo 
glass :: leneno 
glove :: wanita 
go :: kanek 
goat :: tumofu 
gold :: kifiso 
good :: wopa 
government :: lasobo 
grass :: sobinu 
great :: toton 
green :: koleti 
grey :: welipu 
grip :: wawiji 
group :: makuni 
guide :: sibapo 
gun :: fekopu 
hair :: funuka 
hammer :: timofi 
hand :: jiwos 
hanging :: lokatu 
happy :: bojiju 
harbor :: tosanu 
hard :: bomuwo 
harmony :: wobiju 
hat :: lebije 
hate :: fekaku 
have :: saki 
he :: liba 
head :: babej 
healthy :: pelite 
hearing :: memopa 
heart :: fafaku 
heat :: mipute 
help :: tabob 
here :: fiwas 
hi/hello :: jabami 
high :: fijefi 
history :: kekisi 
hole :: fibale 
hollow :: tipeja 
hook :: mopepu 
hope :: bolowe 
horn :: pulaso 
horse :: jubusi 
hospital :: jawawo 
hour :: fulina 
house :: bubas 
how :: lipam 
humor :: sokewi 
I :: pito 
idea :: bitute 
if :: kenet 
ill :: pubemu 
important :: fesuni 
in :: bafop 
increase :: wipamu 
industry :: tofoba 
ink :: wujine 
inside :: pawop 
instrument :: wofenu 
insurance :: momibu 
interest :: lunema 
iron :: sewulo 
island :: mofetu 
it :: supa 
jelly :: wutusa 
jewel :: wunufa 
join :: kekulo 
journey :: saluwe 
judge :: kesomu 
jump :: kuloja 
keep :: babusa 
key :: jusuti 
kick :: kokafo 
kind :: batapa 
kiss :: jeleno 
knee :: suweno 
knife :: makose 
know :: bati 
knowledge :: pekiwi 
land :: seseme 
language :: nawobu 
last :: wonat 
late :: buloku 
laugh :: lekulo 
law :: jewomo 
lead :: kelali 
learning :: pusike 
leather :: tawopu 
left :: webufo 
leg :: linolo 
let :: lutot 
letter :: kemamu 
level :: luleje 
library :: pitebe 
life :: fenob 
lift :: nelete 
light :: foteli 
like :: jutof 
limit :: tewusi 
line :: fewiti 
lip :: tufona 
liquid :: woseta 
list :: kesalo 
listen :: lulaw 
little :: kute 
living :: funite 
lock :: linapi 
long :: lepol 
look :: nokit 
loose :: mimane 
loss :: nufoki 
loud :: mobino 
love :: loki 
low :: likobi 
machine :: kukoma 
make :: pisal 
male :: nelifi 
man :: losa 
manager :: mitika 
map :: nitojo 
mark :: kemoli 
market :: muwase 
married :: fasife 
mass :: sinaju 
match :: mababi 
material :: pokule 
may :: bemotu 
meal :: nulano 
measure :: tupaji 
meat :: mewite 
medical :: lobifa 
meeting :: janoka 
memory :: mafeje 
metal :: sawena 
middle :: jumila 
military :: mimena 
milk :: mifini 
mind :: bibiji 
mine :: busibe 
minute :: bitipa 
mixed :: powitu 
money :: fesis 
monkey :: newuwa 
month :: jopofi 
moon :: komupe 
morning :: bijina 
mother :: fikuj 
motion :: semeje 
mountain :: nasali 
mouth :: jojitu 
move :: biliju 
much :: sufal 
muscle :: tawole 
music :: fupuma 
must :: waboki 
nail :: semeji 
name :: wafub 
narrow :: wuweme 
nation :: pumeti 
natural :: mijafi 
near :: kelumo 
necessary :: manuta 
neck :: lifelo 
need :: pubow 
needle :: tobako 
nerve :: pisulo 
net :: subefe 
new :: kulil 
news :: fowewo 
night :: telal 
no :: buse 
noise :: nefina 
normal :: kukeme 
north :: lejoku 
nose :: kululu 
not :: bimuw 
note :: lokubo 
now :: lamab 
number :: felit 
nut :: sosisu 
observation :: wuneja 
of :: fomu 
off :: pusif 
offer :: kisume 
office :: fifiji 
oil :: mimubu 
old :: bajato 
on :: bawot 
one :: kilu 
only :: kopo 
open :: mifuf 
operation :: mesuku 
opinion :: mikuwi 
opposite :: sukisu 
or :: buno 
orange :: pokoku 
order :: fumene 
organization :: tewowe 
other :: wolej 
out :: kaben 
outside :: bajike 
oven :: wepuka 
over :: pofop 
owner :: pisosa 
page :: mowewe 
pain :: jomala 
paint :: munune 
paper :: banafu 
part :: busamu 
past :: jejale 
paste :: kewopo 
payment :: tulofo 
peace :: kuwuje 
pen :: peneko 
pencil :: watule 
person :: tiwil 
physical :: pabeji 
picture :: witajo 
pig :: mojuwo 
pin :: sopale 
pipe :: sawusa 
place :: bajeji 
plane :: jonubo 
plant :: tiwaba 
plate :: pefuse 
play :: biwasa 
please :: sapup 
pleasure :: kepila 
pocket :: nanube 
point :: fasoli 
poison :: pepima 
polish :: weboko 
political :: posapu 
poor :: jatola 
porter :: sosufe 
position :: komete 
possible :: jijaba 
pot :: pobapo 
potato :: tojufe 
powder :: sopunu 
power :: fasewa 
present :: jukafi 
price :: lonope 
print :: sajeku 
prison :: lamela 
private :: kipupu 
process :: nutemi 
produce :: topuse 
profit :: totuba 
property :: nifese 
protest :: wijite 
public :: koteja 
pull :: jalaju 
pump :: tilose 
punishment :: tefumo 
purpose :: nebaja 
push :: kufoli 
put :: tobop 
quality :: semife 
question :: fifupo 
quick :: jimeja 
quiet :: jetupo 
quite :: fifiko 
rain :: mabosu 
range :: pitele 
rat :: nimeto 
rate :: peliku 
ray :: jonawo 
reaction :: sopoko 
reading :: lelejo 
ready :: bipiki 
reason :: filaja 
receipt :: wunelu 
record :: kamoju 
red :: tifeke 
regret :: pajafe 
regular :: nenepo 
religion :: tapafo 
request :: pejujo 
respect :: koniko 
responsible :: mefibo 
rest :: felapo 
reward :: sewetu 
rhythm :: towuno 
rice :: sulese 
right :: besati 
ring :: jufebu 
river :: lisimi 
road :: jikafe 
robot :: lobo 
rod :: tujojo 
roll :: lekalo 
roof :: nanume 
room :: bifabe 
root :: tupoli 
rough :: mufisu 
round :: lajeja 
rub :: sujelu 
rule :: mafusu 
run :: bobuja 
sad :: lekaja 
safe :: jalawe 
sail :: tatewa 
salt :: sanena 
same :: jebab 
sand :: putiba 
say :: palak 
scale :: wejeta 
school :: bokubo 
science :: mulisi 
screw :: mowapa 
sea :: lesuma 
seat :: kijopo 
second :: bufawa 
secret :: jilaja 
secretary :: nijabi 
see :: make 
seed :: wufobi 
seem :: jalinu 
self :: takanu 
send :: fofuki 
sense :: janulu 
separate :: posiji 
serious :: jabiju 
servant :: tiwine 
sex :: nafewu 
shake :: mofata 
shame :: mimeme 
sharp :: pibuba 
she :: mona 
sheep :: tejoni 
ship :: jitufi 
shirt :: malifu 
shock :: nupawo 
shoe :: nonisa 
short :: kamipu 
shut :: bulumu 
side :: tuwun 
sign :: jamawu 
silk :: watuwi 
silver :: nofiju 
simple :: julewa 
sister :: fofala 
size :: malula 
skin :: mesuba 
skirt :: watemu 
sky :: melifu 
sleep :: masup 
slip :: pefowe 
slow :: kipupi 
small :: jatuwe 
smash :: wiwofe 
smell :: kelowo 
smile :: lililo 
smoke :: lanuna 
smooth :: sesefu 
snake :: pojeja 
snow :: nojebu 
so :: jobew 
soap :: sukumi 
society :: nikajo 
sock :: wepipo 
soft :: ninota 
solid :: fewisu 
some :: nutat 
something :: puku 
son :: bipane 
song :: jowatu 
sort :: futaba 
sound :: mifemo 
soup :: pelake 
south :: latibo 
space :: lalaso 
special :: futatu 
spoon :: wosufo 
spring :: nojime 
square :: nobuki 
stage :: mebame 
star :: kepetu 
start :: bofute 
statement :: nubuno 
station :: kifeji 
stay :: tipet 
steam :: tebewe 
steel :: sepata 
step :: jesime 
stick :: jonefu 
stiff :: wabewa 
still :: wimut 
stitch :: wukewu 
stomach :: nesamu 
stone :: mipesi 
stop :: babalu 
store :: kepete 
story :: fefule 
straight :: jekesa 
strange :: jutota 
street :: jabube 
stretch :: tafali 
strong :: jupusa 
structure :: wakuse 
substance :: wutobo 
such :: bubafo 
sudden :: nibofo 
sugar :: motiwi 
suggestion :: tineti 
summer :: kikama 
sun :: fokibu 
support :: luteka 
surprise :: junapu 
sweet :: lenesi 
swim :: niwaku 
system :: jufifo 
table :: jineme 
tail :: pesuna 
take :: nomes 
talk :: seni 
tall :: nimewi 
taste :: luluno 
tax :: tafapu 
teaching :: samafe 
test :: kefoju 
than :: wobap 
that :: pimo 
then :: pikik 
theory :: nupike 
there :: fopaf 
thick :: tanepu 
thin :: safufi 
thing :: sowob 
this :: bamas 
though :: fiwoju 
thought :: tukaj 
throat :: nanipi 
through :: bebibe 
thumb :: tofepa 
thunder :: tekuka 
ticket :: matubu 
tight :: lunupa 
till :: fosonu 
time :: nojeb 
tin :: wiloki 
tired :: jijoso 
toe :: tijumi 
together :: bitabu 
tommorrow :: bojifu 
tongue :: noleka 
too :: peka 
tooth :: tawuno 
top :: jalule 
touch :: jajujo 
town :: buwija 
trade :: natuta 
train :: jopofo 
transport :: tokijo 
tray :: wofuba 
tree :: latewi 
trick :: majefi 
trouble :: fawufi 
true :: busapa 
turn :: botama 
twist :: timabi 
two :: seju 
umbrella :: wujone 
under :: buneka 
unit :: nakelo 
universe :: tasesa 
up :: kape 
use :: seput 
value :: powako 
very, also the word marker for plural grammatical numbering :: tuji 
vessel :: wejewi 
view :: molali 
violent :: sojufu 
voice :: kafame 
waiting :: fepasa 
walk :: fosit 
wall :: kubitu 
want :: jiwi 
war :: folopi 
warm :: lujesu 
wash :: minuba 
waste :: lopapi 
watch :: bolapo 
water :: tejim 
wave :: pubito 
wax :: wenafe 
way :: nawe 
weather :: nejapa 
week :: fapiko 
weight :: musoko 
well :: lukot 
west :: lepaso 
wet :: mojemu 
what :: biwu 
wheel :: paketa 
while :: bofabi 
whip :: temuwi 
whistle :: sujosi 
white :: fepaka 
who :: mumub 
why :: mojuf 
wide :: pewebe 
will :: nibif 
wind :: lijowe 
window :: kajona 
wine :: lepoba 
wing :: puwitu 
winter :: pataje 
wire :: nuwoma 
wise :: nupomu 
with :: bopup 
woman :: nipib 
wood :: pakula 
word :: fatatu 
word marker for future tense :: jifo 
word marker for past tense :: jifi 
work :: towo 
worm :: wamilu 
wound :: papebe 
writing :: linufu 
wrong :: bemeko 
year :: buliwi 
yellow :: wipoba 
yesterday :: joninu 
you :: bama 
young :: fafobe 

You are a good person. :: Bama wopa tiwil.
I really liked to know you. :: Pito loki jifi bati bama.
I love this fruit. :: Pito loki wikute.
I love all fruits. :: Pito loki wikute tuji.
I can go left or right. :: Pito leto fosit webufo buno besati.
I am walking to the house. :: Pito fosit bubas.
I walked to the house. :: Pito fosit jifi bubas.
I will walk to the house. :: Pito fosit jifo bubas.
Do not listen to her. :: Buse lulaw mona.
What color is the musuem? :: Biwu wekepo buse kulil bubas?
I think this musuem is very dirty and bad. :: Pito wetok pimo buse kulil bubas topik sowu bujeti.
He saw (the) bird. :: Liba make jifi mipuki.
I am going. :: Pimo kapim kanek.
He might be ill. :: Liba bemotu mufe pubemu.
go forward ::  kanek koloke 
go backward ::  kanek nole 
turn left ::  botama webufo 
turn right ::  botama besati 
turn back ::  botama nole 
go quickly ::  kanek jimeja  
go slowly ::  kanek kipupi 
stop ::  buse kanek 
ok/good :: wopa
other way  (when the robot bumps into something) :: wolej nawe
I turn left. :: Pito botama webufo. 
I turned left. :: Pito botama jifi webufo.
I like robots. :: Pito jutof lobo tuji. 
I put red ball. :: pito tobop tifeke jinolu.
I put blue ball. :: pito tobop kutuju jinolu.
I put green ball. :: pito tobop koleti jinolu.
I put yellow ball. :: pito tobop wipoba jinolu.


